{
  "LOY_departures": [
    "9:15",
    "9:30",
    "9:45",
    "10:15",
    "10:30",
    "10:45",
    "11:15",
    "11:30",
    "11:45",
    "12:15",
    "12:30",
    "12:45",
    "13:15",
    "13:30",
    "13:45",
    "14:15",
    "14:30",
    "14:45",
    "15:15",
    "15:30",
    "15:45",
    "16:15",
    "16:30",
    "16:45",
    "17:15",
    "17:30",
    "17:45",
    "18:15",
    "18:30"
  ],
  "SGW_departures": [
    "9:30",
    "9:45",
    "10:15",
    "10:30",
    "10:45",
    "11:15",
    "11:30",
    "11:45",
    "12:15",
    "12:30",
    "12:45",
    "13:15",
    "13:30",
    "13:45",
    "14:15",
    "14:30",
    "14:45",
    "15:15",
    "15:30",
    "15:45",
    "16:15",
    "16:30",
    "16:45",
    "17:15",
    "17:30",
    "17:45",
    "18:15",
    "18:30"
  ],
  "last_departure": {
    "LOY": "18:30",
    "SGW": "18:30"
  }
}
